-----------------------
---WWW---W-------------
-----WW--W-------W-----
--W---WWWWW------W-----
--W------WWW-----W-----
--W---S--WWWWWWWWWWW---
--WWWWW---WWW------W---
-WW---WW--WWW-WWW--WWW-
-WW-W-WW---W--WE---WWW-
-WWWW--WW--W--WWWWWWW--
--------WWWW---W-WW----
-----------------------