--------S-----------W--
--------WWWWWWWWW---W--
--------W-------W---W--
--------W-W-----W---W--
------WWW-WWWW--W-WWW--
------WWW-WWEW--W-W----
--W---WWW-WW-W--W-W----
-WWW--WWW----WWWW-W----
-WWW--WWW-----W---W----
WWWWW-WWWWW---WWWWW----
----W------------------
----W------------------
