--------WWWWWWW--------
W---W------WWWW--------
WS-WWW------WWW--------
WWWWWWW-W----WW--------
E--W--W-W--------------
---W--W-W--------------
---W--W-WWW--W---------
-WWW--WWWWW--WW--------
----------W--WWW-------
----------WWWWWWW------
---------------W-------
-----------------------
